25
...o......oo..........o..o...o.o..
..o.......o..o.o.oo......o..o.....
...o..o.........o........o.......o
....oo.o.o...o.o....o.............
..ooo....oo........o..o...o.......
.o..................o...o....o....
......oo...o.....o.....o..o.....o.
.....o...o......o......oo.o..o....
.o.o......o...o...o...o...........
.o..o.........o...o.o.o..oo...o...
....................o.....o.......
..............o...oo.......o......
...........ooo.....oo.....o....o..
.....o.....o............o.....oo..
...................o...........o..
.oooo...........o..o..............
........o......oo....o.......o....
..oo......o.o......o..............
...o...........o..o.........o.....
.......o..oo...........o..o.o..o.o
..o.........o....oo............o.o
.......o.o..o............o....o...
..o..o..............oo...o........
o.o......o.........o..o.......o.o.
....o...o.............o....o..ooo.
