39
.........o...o.o......o...................
..........................................
...o..o...................................
..............o...........................
...o.....o.................o.oo...........
........o...................o.............
..........................o...............
..........o..o....o..o.....o..o...........
...........................o.....o.....o..
...ooo........o.........o.ooo....o........
..........................o.......o.......
..oo..........................o...........
.o....o....................o.o............
...........o...o..........................
.o.....oo......o..........................
......oo......o...o............o...o......
..................o..o..o...............o.
o..o..........o..........o................
.............o.o..........................
....o......o.....oo.......................
.........o............o....o..............
...................o..o..........o.o......
o.o.............................o.........
.......o.......o..o....o...............o..
..............................o....o......
......o...................................
.o..................o........o.........o..
.................o........................
..o............................o........o.
............o.......o..........o..........
..o....o.....o......................o.....
................o..oo......o....o.........
...........o....o.................o.......
....................o...........ooo......o
..o....................o.............o....
..............o....o...............o......
....................o..........o...o......
.o.o............o..o....o...o...o.........
......o........o.............o............
