17
....o.....o..o.o....
.oo..o............oo
.ooo........o.o.....
......o..o.o.o.o....
oo..o......oo.....oo
.oo.oo....o.........
.o.o....o..........o
......oo..ooo....o.o
o....o.oo.o.o....o.o
.o......oo........o.
.....o..o..o..oo...o
oo..........oo....o.
o..o...o......oo....
o.o.o...o..o..o.....
...........oo....o..
.o.......o.o....oo..
.o.ooo..o..o..o.....
