11
.ooo.o.o...........oo.oo
o.........o.oo.ooo.oo.o.
.oooo....o.....oo...o...
....o..o..oo...ooo.oo...
....o.oo.o.oo.oo....oo..
..o.o..o..o..o....o.....
o..oooo.oooo.oo..o......
.ooo.o..oooo.oo..o.o..oo
o.o...oo.oo....o........
.....ooo.o...oo.o...oo..
..........o.o......o.o..
