22
.o.......o..
...o.oo.o.o.
...o...o..oo
o..o.....o..
...o.......o
..oo......o.
......o.....
..o.o....oo.
.......o....
o.........o.
.o...o..oo.o
.........o..
......oo.oo.
......oo...o
o..o..o..oo.
....ooo.....
...o.....o..
..o.......o.
o...........
..o...o.....
......oo....
o.oo........
